00000000000000000000000000000000000000000000000000000000000000000
00000000000000000000000000000000000000000000000000000000000000000
00000000010000000000000000000000000000000100000000000000000000000
00000000010000000000000000000000000000000100000000000000000000000
00000000010000000000000000000000000000000100000000000000000000000
00000000010000000000000000000000000000000100000000000000000000000
00000000010000000000000000000000000000000100000000000001000000000
00000011111111111111111111111111111111111111100000000001000000000
00000010000000000100000000000100000000000000100000000001000000000
00000010000000000100000000000100000000000000100000000001000000000
00000010000000000100000000000100000000000000100000000001000000000
00000010000000000111110001111111111111111111100000000001000000000
00000010000000000100010001000000000000000000100000000001000000000
00000010000000000100010001000000000000000000100000000001000000000
00000010000000000100010001000000000000000000111111111111000000000
00000010000000000100010001000000000000000000100000000001000000000
00000010000000000100010001111111111111111111111111111111000000000
00000010000000000100010001000000000000000000000000000001000000000
00000010000000000100010001000000000000000000000000000001000000000
00000010000000000100010001000000000000000000000000000001000000000
00000010000000000100010001000000000000000000000000000001000000000
00000010000000000100010001000000000000000000000000000001000000000
00000011111111111111111111111111111111111111111111111111111111111
00000010000000000000000001000000000000000000000000000100000000000
00000010000000000000000001000000000000000000000000000100000000000
00000010000000000000000001000000000000000000000000000100000000000
00000010000000000000000001000000000000000000000000000100000000000
00000010000000000000000001000000000000000000000000000100000000000
00000010000000000000000001000000000000000000000000000100000000000
00000010000000000000000001000000000000000000000000000100000000000
00000010000000000000000001111111111111111111111111111100000000000
00000010000000000000000001000000000000000000000000000100000000000
00000010000000000000000001000000000000000000000000000100000000000
00000010000000000000000001000000000000000000000000000100000000000
00000011111111111111000001000000000000000000000000000100000000000
00000010000000000000000001111111111111111111111111111111111111110
00000010000000000000000001000000000100000000000000000000000000000
00000011111111111111111111000000000100000000000000000000000000000
00000010000000000000000001000000000100000000000000000000000000000
00000010000000000000000001000000000100000000000000000000000000000
00000010000000000000000001000000000100000000000000000000000000000
00000010000000000000000001000000000100000000000000000000000000000
00000010000000000000000000000000000000000000000000000000000000000
00000010000000000000000000000000000000000000000000000000000000000
00000000000000000000000000000000000000000000000000000000000000000
00000000000000000000000000000000000000000000000000000000000000000